# Parts
{{full_name}}       | {{short_name}} | {{chinese_name}}
B.F. Sword          | sword          | 大剑
Recurve Bow         | bow            | 弓
Chain Vest          | vest           | 护甲
Negatron Cloak      | cloak          | 斗篷
Needlessly Large Rod| rod            | 大棒
Tear of the Goddess | tear           | 眼泪
Giant's Belt        | belt           | 腰带
Sparring Gloves     | glove          | 拳套
Spatula             | spatula        | 铲
Frying Pan          | pan            | 锅(s12+)
Pfannenwender       |                | (s5)
Shadow Spatula      |                | (s5)



# Property
{{full_name}}          | {{short_name}} | {{chinese_name}} 
Attack Damage          | AD            | 物攻
Attack Speed           | AS            | 攻速
Armor                  | AR            | 物抗
Magic Resist           | MR            | 法抗
Health                 | HP            | 生命
Range                  | RG            | 攻击距离
Ability Power          | AP            | 法强
Mana                   | MP            | 蓝量
Omnivamp               | OV            | 吸血
Damage Amp             | DA            | 伤害增幅
Durability             | DR            | 伤害减免
Critical Strike Chance | CR            | 暴击率
Critical Strike Damage | DPS           | 暴击伤害



# SpecialEffect
{{full_name}} | {{desc}}                                                               | {{chinese_name}}
Burn          | Deals a percent of the target's max Health as true damage every second | 灼烧
Wound         | Reduces healing received                                               | 重伤
Shield        |                                                                        | 护盾
Shred         | Reduce Magic Resist                                                    | 法穿
Sunder        | Reduce Armor                                                           | 物穿
invulnerable  | untargetable and shed negative effects                                 | 霸体
immunity to crowd control                                                              | 免控
execute enemies below X% of their maximum Health                                       | 斩杀
Chill         | reduce Attack Speed                                                    | 冰冷
Mana Reave    | increase maximum Mana until the next cast                              | 破法
ignore X% of the target's Armor and Magic Resist                                       | 无视抗性
increased movement speed                                                               | 移速



# Bond level
Prismatic
Gold/Unique
Silver
Bronze